name	seq	barcode_num	barcode
PacBioFwdV2-0	GGCAAACGCGCCATTCGTGTCGGTTAGAAGCACTAAATCGGAACCCTAAAG	0	CGGTTAGA
PacBioFwdV2-1	GGCAAACGCGCCATTCGTGTCCCTCTTTAGCACTAAATCGGAACCCTAAAG	1	CCCTCTTT
PacBioFwdV2-2	GGCAAACGCGCCATTCGTGTCGTTTCTGAGCACTAAATCGGAACCCTAAAG	2	CGTTTCTG
PacBioFwdV2-3	GGCAAACGCGCCATTCGTGTATGGATCGAGCACTAAATCGGAACCCTAAAG	3	ATGGATCG
PacBioFwdV2-4	GGCAAACGCGCCATTCGTGTGGTAACACAGCACTAAATCGGAACCCTAAAG	4	GGTAACAC
PacBioFwdV2-5	GGCAAACGCGCCATTCGTGTCAAGCAGAAGCACTAAATCGGAACCCTAAAG	5	CAAGCAGA
PacBioFwdV2-6	GGCAAACGCGCCATTCGTGTACCTCAGTAGCACTAAATCGGAACCCTAAAG	6	ACCTCAGT
PacBioFwdV2-7	GGCAAACGCGCCATTCGTGTTTGGCGAAAGCACTAAATCGGAACCCTAAAG	7	TTGGCGAA
PacBioFwdV2-8	GGCAAACGCGCCATTCGTGTCCATGATGAGCACTAAATCGGAACCCTAAAG	8	CCATGATG
PacBioFwdV2-9	GGCAAACGCGCCATTCGTGTCAAGTCTCAGCACTAAATCGGAACCCTAAAG	9	CAAGTCTC
PacBioFwdV2-10	GGCAAACGCGCCATTCGTGTCGCGAAATAGCACTAAATCGGAACCCTAAAG	10	CGCGAAAT
PacBioFwdV2-11	GGCAAACGCGCCATTCGTGTCAAGCCAAAGCACTAAATCGGAACCCTAAAG	11	CAAGCCAA
PacBioFwdV2-12	GGCAAACGCGCCATTCGTGTGCCGTATAAGCACTAAATCGGAACCCTAAAG	12	GCCGTATA
PacBioFwdV2-13	GGCAAACGCGCCATTCGTGTTAGGTCTCAGCACTAAATCGGAACCCTAAAG	13	TAGGTCTC
PacBioFwdV2-14	GGCAAACGCGCCATTCGTGTGGTTGAGAAGCACTAAATCGGAACCCTAAAG	14	GGTTGAGA
PacBioFwdV2-15	GGCAAACGCGCCATTCGTGTATTGAGCCAGCACTAAATCGGAACCCTAAAG	15	ATTGAGCC
PacBioFwdV2-16	GGCAAACGCGCCATTCGTGTTCTTTGGCAGCACTAAATCGGAACCCTAAAG	16	TCTTTGGC
PacBioFwdV2-17	GGCAAACGCGCCATTCGTGTTATGGGGAAGCACTAAATCGGAACCCTAAAG	17	TATGGGGA
PacBioFwdV2-18	GGCAAACGCGCCATTCGTGTTACGCAAGAGCACTAAATCGGAACCCTAAAG	18	TACGCAAG
PacBioFwdV2-19	GGCAAACGCGCCATTCGTGTCCTCTCAAAGCACTAAATCGGAACCCTAAAG	19	CCTCTCAA
PacBioFwdV2-20	GGCAAACGCGCCATTCGTGTACAGTCGAAGCACTAAATCGGAACCCTAAAG	20	ACAGTCGA
PacBioFwdV2-21	GGCAAACGCGCCATTCGTGTCAATGCTCAGCACTAAATCGGAACCCTAAAG	21	CAATGCTC
PacBioFwdV2-22	GGCAAACGCGCCATTCGTGTTTATCCCGAGCACTAAATCGGAACCCTAAAG	22	TTATCCCG
PacBioFwdV2-23	GGCAAACGCGCCATTCGTGTCGTCAATCAGCACTAAATCGGAACCCTAAAG	23	CGTCAATC
PacBioFwdV2-24	GGCAAACGCGCCATTCGTGTCACCTATGAGCACTAAATCGGAACCCTAAAG	24	CACCTATG
PacBioFwdV2-25	GGCAAACGCGCCATTCGTGTACGGAACAAGCACTAAATCGGAACCCTAAAG	25	ACGGAACA
PacBioFwdV2-26	GGCAAACGCGCCATTCGTGTCTTGGCTTAGCACTAAATCGGAACCCTAAAG	26	CTTGGCTT
PacBioFwdV2-27	GGCAAACGCGCCATTCGTGTATTGCTGGAGCACTAAATCGGAACCCTAAAG	27	ATTGCTGG
PacBioFwdV2-28	GGCAAACGCGCCATTCGTGTTGGTAACCAGCACTAAATCGGAACCCTAAAG	28	TGGTAACC
PacBioFwdV2-29	GGCAAACGCGCCATTCGTGTAGACACTCAGCACTAAATCGGAACCCTAAAG	29	AGACACTC
PacBioRevV2-0	ACATTCGCGCACGTGGTGCACGGTTAGAGGCGAACTACTTACTCTAGCTTCC	0	CGGTTAGA
PacBioRevV2-1	ACATTCGCGCACGTGGTGCACCCTCTTTGGCGAACTACTTACTCTAGCTTCC	1	CCCTCTTT
PacBioRevV2-2	ACATTCGCGCACGTGGTGCACGTTTCTGGGCGAACTACTTACTCTAGCTTCC	2	CGTTTCTG
PacBioRevV2-3	ACATTCGCGCACGTGGTGCAATGGATCGGGCGAACTACTTACTCTAGCTTCC	3	ATGGATCG
PacBioRevV2-4	ACATTCGCGCACGTGGTGCAGGTAACACGGCGAACTACTTACTCTAGCTTCC	4	GGTAACAC
PacBioRevV2-5	ACATTCGCGCACGTGGTGCACAAGCAGAGGCGAACTACTTACTCTAGCTTCC	5	CAAGCAGA
PacBioRevV2-6	ACATTCGCGCACGTGGTGCAACCTCAGTGGCGAACTACTTACTCTAGCTTCC	6	ACCTCAGT
PacBioRevV2-7	ACATTCGCGCACGTGGTGCATTGGCGAAGGCGAACTACTTACTCTAGCTTCC	7	TTGGCGAA
PacBioRevV2-8	ACATTCGCGCACGTGGTGCACCATGATGGGCGAACTACTTACTCTAGCTTCC	8	CCATGATG
PacBioRevV2-9	ACATTCGCGCACGTGGTGCACAAGTCTCGGCGAACTACTTACTCTAGCTTCC	9	CAAGTCTC
PacBioRevV2-10	ACATTCGCGCACGTGGTGCACGCGAAATGGCGAACTACTTACTCTAGCTTCC	10	CGCGAAAT
PacBioRevV2-11	ACATTCGCGCACGTGGTGCACAAGCCAAGGCGAACTACTTACTCTAGCTTCC	11	CAAGCCAA
PacBioRevV2-12	ACATTCGCGCACGTGGTGCAGCCGTATAGGCGAACTACTTACTCTAGCTTCC	12	GCCGTATA
PacBioRevV2-13	ACATTCGCGCACGTGGTGCATAGGTCTCGGCGAACTACTTACTCTAGCTTCC	13	TAGGTCTC
PacBioRevV2-14	ACATTCGCGCACGTGGTGCAGGTTGAGAGGCGAACTACTTACTCTAGCTTCC	14	GGTTGAGA
PacBioRevV2-15	ACATTCGCGCACGTGGTGCAATTGAGCCGGCGAACTACTTACTCTAGCTTCC	15	ATTGAGCC
PacBioRevV2-16	ACATTCGCGCACGTGGTGCATCTTTGGCGGCGAACTACTTACTCTAGCTTCC	16	TCTTTGGC
PacBioRevV2-17	ACATTCGCGCACGTGGTGCATATGGGGAGGCGAACTACTTACTCTAGCTTCC	17	TATGGGGA
PacBioRevV2-18	ACATTCGCGCACGTGGTGCATACGCAAGGGCGAACTACTTACTCTAGCTTCC	18	TACGCAAG
PacBioRevV2-19	ACATTCGCGCACGTGGTGCACCTCTCAAGGCGAACTACTTACTCTAGCTTCC	19	CCTCTCAA
PacBioRevV2-20	ACATTCGCGCACGTGGTGCAACAGTCGAGGCGAACTACTTACTCTAGCTTCC	20	ACAGTCGA
PacBioRevV2-21	ACATTCGCGCACGTGGTGCACAATGCTCGGCGAACTACTTACTCTAGCTTCC	21	CAATGCTC
PacBioRevV2-22	ACATTCGCGCACGTGGTGCATTATCCCGGGCGAACTACTTACTCTAGCTTCC	22	TTATCCCG
PacBioRevV2-23	ACATTCGCGCACGTGGTGCACGTCAATCGGCGAACTACTTACTCTAGCTTCC	23	CGTCAATC
PacBioRevV2-24	ACATTCGCGCACGTGGTGCACACCTATGGGCGAACTACTTACTCTAGCTTCC	24	CACCTATG
PacBioRevV2-25	ACATTCGCGCACGTGGTGCAACGGAACAGGCGAACTACTTACTCTAGCTTCC	25	ACGGAACA
PacBioRevV2-26	ACATTCGCGCACGTGGTGCACTTGGCTTGGCGAACTACTTACTCTAGCTTCC	26	CTTGGCTT
PacBioRevV2-27	ACATTCGCGCACGTGGTGCAATTGCTGGGGCGAACTACTTACTCTAGCTTCC	27	ATTGCTGG
PacBioRevV2-28	ACATTCGCGCACGTGGTGCATGGTAACCGGCGAACTACTTACTCTAGCTTCC	28	TGGTAACC
PacBioRevV2-29	ACATTCGCGCACGTGGTGCAAGACACTCGGCGAACTACTTACTCTAGCTTCC	29	AGACACTC
PacBioRevV2-24-P9	ACATTCGCGCACGTGGTGCACACCTATGTCTCATGACCAAAATCCCTTAACG	24	CACCTATG
PacBioRevV2-25-P9	ACATTCGCGCACGTGGTGCAACGGAACATCTCATGACCAAAATCCCTTAACG	25	ACGGAACA
PacBioRevV2-26-P9	ACATTCGCGCACGTGGTGCACTTGGCTTTCTCATGACCAAAATCCCTTAACG	26	CTTGGCTT
PacBioRevV2-27-P9	ACATTCGCGCACGTGGTGCAATTGCTGGTCTCATGACCAAAATCCCTTAACG	27	ATTGCTGG
PacBioRevV2-15-ApalI	ACATTCGCGCACGTGGTGCAattgagccCTACACCGAACTGAGATACCTACA	15	ATTGAGCC
PacBioRevV2-16-ApalI	ACATTCGCGCACGTGGTGCAtctttggcCTACACCGAACTGAGATACCTACA	16	TCTTTGGC
PacBioRevV2-17-ApalI	ACATTCGCGCACGTGGTGCAtatggggaCTACACCGAACTGAGATACCTACA	17	TATGGGGA
PacBioRevV2-18-ApalI	ACATTCGCGCACGTGGTGCAtacgcaagCTACACCGAACTGAGATACCTACA	18	TACGCAAG
PacBioFwdV2-SSB-18	GGCAAACGCGCCATTCGTGTTACGCAAGCATCAAGCTTATCGATACCG		
PacBioFwdV2-SSB-19	GGCAAACGCGCCATTCGTGTCCTCTCAACATCAAGCTTATCGATACCG		
PacBioFwdV2-SSB-18-1	GGCAAACGCGCCATTCGTGTTACGCAAGGTCTGGAGTACTGAATAAACGGA		
